Stage 1
#######
### ###
###O###
###o###
#OoPoO#
###o###
###O###
#######
Stage 2
  #######
###  O  ###
#    o    #
# Oo P oO #
###  o  ###
 #   O  #
 ########
Stage 3
  #######
###  O  ###
#    o    #
# Oo P oO #
###  o  ###
 #   O  #
 ########
Stage 4
  #######
###  O  ###
#    o    #
# Oo P oO #
###  o  ###
 #   O  #
 ########
Stage 5
  #######
###  O  ###
#    o    #
# Oo P oO #
###  o  ###
 #   O  #
 ########